64 24
0 0 0 0 0 0 0 0 0 0 0 0 0 0 0 0 0 0 0 0 0 0 0 0 0 0 0 0 0 0 0 211 212 0 0 0 0 0 0 0 0 0 0 0 0 0 0 0 0 0 0 0 0 24 23 0 0 0 0 0 0 0 0 0 
0 0 0 0 0 0 0 0 0 0 0 0 0 0 0 0 0 0 0 0 0 0 0 7 1 27 1 1 1 19 1 231 232 1 1 27 1 1 19 1 1 1 6 0 0 0 0 0 0 0 0 0 0 4 21 23 0 0 0 0 0 0 0 0 
0 0 0 0 0 0 0 0 0 0 0 0 0 0 0 0 7 1 1 19 1 221 222 12 17 17 17 20 17 17 17 18 17 17 17 20 17 17 17 18 17 17 9 1 6 0 0 0 0 211 212 0 24 22 18 3 0 0 0 0 0 0 0 0 
0 0 0 0 0 0 0 0 0 0 0 0 0 0 24 1 22 17 17 17 20 17 17 17 18 17 10 234 2 2 2 2 2 2 2 2 2 2 2 2 2 11 17 17 9 1 1 19 1 231 232 1 22 17 17 21 27 23 0 0 0 0 0 0 
0 0 0 0 0 0 0 0 0 0 0 0 0 15 22 17 17 17 18 17 17 17 17 17 17 10 5 81 0 0 0 0 0 0 0 0 0 0 0 0 0 8 11 18 17 17 17 17 17 17 18 17 17 17 17 17 17 21 23 0 0 0 0 0 
0 0 0 0 0 0 0 0 0 0 15 19 16 17 17 17 20 17 17 17 17 17 17 17 10 5 0 100 114 115 85 0 0 0 0 0 0 0 0 0 0 0 8 2 11 17 17 20 17 17 17 17 17 20 17 17 18 17 9 19 6 0 0 0 
28 6 0 0 0 7 28 1 1 16 17 20 17 17 18 17 17 17 17 17 17 17 17 17 9 6 0 0 0 0 94 0 0 0 0 0 0 0 0 0 0 0 0 0 8 2 2 2 2 2 2 2 2 2 2 11 17 17 17 17 9 1 14 0 
20 3 0 0 0 4 20 17 17 17 17 17 17 17 17 17 17 17 17 17 17 17 17 20 10 5 0 24 1 1 233 6 0 0 0 0 0 0 0 0 0 0 0 0 0 0 0 0 0 0 0 0 0 0 0 8 11 17 18 17 17 17 20 13 
18 33 116 116 116 34 17 18 17 17 17 17 17 17 17 17 17 17 17 17 17 17 17 17 3 0 151 40 17 20 17 9 14 0 0 0 0 0 0 0 0 0 0 0 0 24 23 0 0 0 0 0 0 0 0 0 8 2 2 2 2 11 17 17 
17 3 0 0 0 4 17 17 20 17 17 17 17 17 17 17 17 17 17 17 17 17 17 17 3 0 0 8 11 17 18 17 17 13 14 0 0 0 0 0 0 0 0 0 15 12 3 0 0 0 0 0 0 0 0 0 0 0 0 0 0 8 2 11 
17 3 0 0 0 4 17 17 17 17 17 17 17 17 17 17 17 17 17 17 17 17 17 18 21 23 0 0 4 17 17 17 17 18 17 13 1 1 1 1 1 1 1 16 17 20 3 0 0 0 0 0 0 0 0 0 0 7 6 0 0 0 0 4 
17 33 116 116 116 34 20 17 17 17 17 18 17 17 17 17 17 17 17 17 17 17 17 17 17 39 77 0 4 17 17 17 17 17 17 20 17 18 17 17 17 17 17 17 18 17 3 0 0 0 0 0 0 0 0 0 0 160 9 6 0 0 0 4 
18 3 0 0 0 4 17 17 17 17 17 17 17 17 17 17 17 17 17 17 17 17 20 10 2 5 0 7 12 17 17 17 17 17 17 17 17 17 17 17 20 17 17 17 17 17 9 14 0 0 0 0 0 0 0 15 1 22 17 9 6 0 0 4 
17 3 0 0 0 4 17 17 17 17 17 17 17 17 17 17 17 17 17 17 17 17 17 3 0 0 151 40 20 17 17 17 17 17 17 17 17 17 17 17 17 17 17 17 17 17 17 17 13 1 1 1 1 1 16 17 20 17 18 17 3 0 0 4 
17 9 19 6 0 4 17 17 17 17 17 17 18 17 17 17 17 17 17 18 17 17 17 3 0 0 0 4 17 18 17 17 17 17 17 17 18 17 17 17 17 10 2 2 2 11 17 18 17 17 17 17 20 17 18 17 17 17 17 17 3 0 0 4 
20 10 2 5 0 4 17 18 17 17 17 17 17 17 17 20 17 17 17 17 17 17 10 5 0 0 0 8 11 17 17 20 17 17 17 17 17 17 20 17 10 5 0 0 0 8 2 238 11 17 17 17 17 17 17 17 17 20 10 234 5 0 0 4 
17 3 0 24 1 22 17 17 17 10 2 2 2 2 2 2 11 17 17 20 10 2 5 0 0 0 0 0 8 234 2 2 2 2 2 2 2 2 2 2 5 0 0 0 0 0 0 0 8 2 2 2 2 2 2 238 2 234 5 94 0 0 0 4 
17 3 0 4 17 20 17 17 10 5 0 0 0 0 0 0 8 2 238 2 5 0 0 0 0 0 0 0 0 94 0 0 0 0 0 0 0 0 0 0 0 0 0 0 0 0 0 0 0 0 0 0 0 0 0 0 0 87 89 88 0 24 1 22 
20 3 0 4 18 17 17 10 5 0 0 0 0 0 0 0 0 0 0 0 0 0 0 0 0 0 0 0 0 87 82 114 115 93 98 0 0 0 0 0 0 7 6 0 0 0 0 0 0 0 0 0 0 0 0 0 0 0 133 134 0 4 20 17 
17 3 0 8 2 2 2 5 0 0 0 0 0 0 0 0 0 0 0 0 0 0 0 0 0 0 0 0 0 0 0 0 0 0 81 0 0 111 0 0 0 4 3 0 0 0 0 0 0 0 0 0 0 0 0 0 0 0 135 136 0 4 17 18 
17 21 23 0 0 0 0 0 0 0 0 0 0 0 0 0 0 0 0 0 0 0 0 0 0 0 0 0 0 0 0 0 0 0 81 0 0 81 0 0 0 4 3 0 0 0 0 0 0 0 0 0 0 0 0 0 0 7 233 233 19 12 17 17 
17 17 21 14 0 0 0 0 0 0 0 0 0 0 0 0 0 0 0 0 7 27 1 19 1 221 222 1 1 1 1 19 1 1 233 27 23 90 98 24 1 12 9 72 155 41 41 41 41 41 155 73 1 1 19 1 1 22 17 20 17 17 17 17 
18 17 17 17 13 1 27 237 19 1 1 237 72 41 197 41 73 19 1 1 12 17 18 17 17 20 17 17 17 17 20 17 17 17 17 18 21 233 233 22 18 17 20 74 75 75 75 75 75 75 75 76 17 17 18 17 17 17 17 18 17 17 17 17 
17 17 17 17 17 20 17 17 18 17 17 20 74 75 75 75 76 17 17 17 17 17 17 17 17 17 17 17 17 17 18 17 17 17 17 17 17 20 17 17 17 17 17 17 17 18 17 17 17 17 17 20 17 17 17 17 17 17 17 17 17 17 17 17 

14 0
0 1

2
40 16 1
50 19 1

0
