20 13
0 0 0 0 0 0 0 0 0 0 0 0 0 0 0 0 0 0 0 0 
0 0 0 0 0 0 0 0 0 0 0 0 0 0 0 0 0 0 0 0 
0 0 0 0 0 0 0 0 0 0 0 0 0 0 7 1 19 1 23 24 
0 0 0 0 0 0 0 0 0 0 0 0 0 0 4 17 17 17 21 22 
1 19 6 0 0 0 0 0 0 0 0 0 0 0 4 17 20 17 18 17 
17 17 3 0 0 0 0 0 0 0 0 0 0 7 12 17 17 17 17 17 
17 17 33 116 116 116 116 116 116 116 116 116 116 34 17 17 17 17 17 17 
18 17 3 0 0 0 0 0 0 0 0 0 0 4 17 17 17 17 17 20 
17 17 3 0 0 0 0 0 0 0 0 24 1 12 17 18 17 17 17 17 
17 17 21 23 0 0 111 0 0 0 24 22 17 17 17 17 17 17 17 17 
20 17 17 21 6 0 81 7 28 1 22 17 20 17 17 17 17 20 17 17 
17 17 18 17 9 1 233 12 17 17 17 17 17 17 18 17 17 17 18 17 
17 17 17 17 17 17 17 17 17 17 18 17 17 17 17 17 17 17 17 17 

0

0
