20 20
0 0 0 0 0 0 0 0 0 0 0 0 0 0 0 0 0 0 0 0 
148 106 0 0 0 0 0 107 148 129 101 124 0 0 0 0 0 0 0 0 
127 163 116 116 116 116 116 164 127 127 127 127 123 124 0 0 0 107 101 129 
128 109 106 0 0 0 0 104 127 128 127 127 130 127 123 106 0 108 121 130 
127 127 103 0 0 0 107 142 127 127 127 127 127 127 127 103 0 0 104 127 
127 127 195 132 114 115 196 127 128 127 127 127 127 128 127 195 114 115 196 127 
127 128 103 0 0 0 108 102 121 127 127 127 127 127 127 103 0 0 104 127 
127 127 103 0 0 0 0 0 108 102 102 102 121 127 127 103 0 0 104 127 
127 110 105 0 0 0 0 0 0 0 0 0 108 102 102 105 0 0 104 127 
130 103 0 0 0 0 0 0 0 0 0 0 0 0 0 0 0 0 104 127 
127 103 0 0 0 0 0 0 0 0 0 144 106 0 0 0 0 0 104 127 
127 179 0 0 0 0 0 107 143 0 107 122 109 177 106 0 0 0 104 130 
127 103 0 0 0 0 0 104 141 129 122 127 127 127 109 147 106 0 104 127 
127 109 106 0 0 0 0 104 130 127 127 127 130 127 127 127 103 0 104 127 
130 127 103 0 0 0 107 122 127 127 127 127 127 127 127 127 103 0 104 127 
127 110 105 0 0 0 104 127 127 127 127 127 127 127 127 127 103 0 104 127 
127 103 0 0 0 0 104 130 127 127 127 127 127 127 130 127 103 0 104 127 
127 103 0 0 111 107 122 127 127 127 127 127 127 127 127 127 109 117 122 127 
127 109 101 106 81 104 127 127 127 127 127 127 127 127 127 127 127 127 127 127 
127 127 127 109 193 122 127 127 127 127 127 127 127 127 127 127 127 127 127 127 

14 0
0 1

0

1
