30 32
101 141 143 0 0 144 149 101 106 0 0 0 0 0 0 0 0 0 0 0 0 0 0 0 0 0 0 0 0 0 
127 127 195 114 115 196 127 127 109 124 0 0 0 0 0 0 0 0 0 0 0 0 0 0 0 0 0 0 0 0 
130 127 103 0 0 104 127 130 127 127 123 143 0 0 0 0 0 0 0 0 0 0 0 0 0 0 0 0 0 0 
127 127 103 0 0 104 127 127 127 127 127 141 106 0 0 0 0 0 0 0 0 0 0 0 0 0 0 0 0 0 
110 102 105 144 101 122 127 127 127 127 127 110 105 0 0 0 0 0 0 0 0 0 0 0 0 0 0 0 0 0 
163 116 116 164 127 127 128 127 127 130 127 109 101 124 0 144 143 0 0 0 0 0 0 0 0 0 0 0 0 0 
103 0 0 108 121 127 127 127 127 127 127 127 127 127 123 122 141 143 189 190 0 0 0 0 0 0 0 0 0 0 
103 0 0 0 108 102 178 102 178 168 121 127 127 127 127 127 128 141 191 192 207 208 101 101 106 0 0 0 0 144 
179 0 0 0 0 0 0 0 0 131 108 102 102 102 121 127 127 127 127 127 227 228 127 130 109 106 0 0 107 122 
109 124 0 0 0 0 0 0 0 131 0 0 0 0 108 102 102 102 121 127 127 127 127 127 127 195 114 115 196 130 
127 127 123 143 0 0 0 0 0 131 0 0 0 0 0 0 0 0 180 127 127 127 128 127 127 163 116 116 164 127 
127 130 127 179 0 0 0 0 0 131 0 0 0 0 0 0 0 0 108 102 194 121 127 127 127 179 0 0 108 121 
127 127 127 103 0 0 0 0 0 131 0 47 155 41 155 46 0 0 0 0 81 108 194 194 194 105 0 0 0 180 
127 127 127 109 124 0 0 0 0 131 0 176 65 57 65 175 0 0 0 47 213 41 213 213 213 46 0 0 0 180 
127 127 128 127 127 123 129 143 0 131 0 44 65 57 65 43 0 0 0 176 65 65 57 65 65 43 0 0 144 122 
127 127 127 127 130 127 127 141 143 131 0 176 57 65 57 175 0 0 0 44 57 57 50 68 42 45 0 125 142 127 
127 127 127 127 127 127 127 127 103 131 0 44 65 57 65 43 0 0 0 176 57 57 43 0 0 144 126 127 130 127 
127 127 127 127 127 128 127 127 103 131 0 176 65 57 65 175 0 0 0 44 57 57 43 0 0 180 127 127 127 127 
128 127 127 127 127 127 127 127 109 167 106 48 214 214 214 45 0 0 0 176 57 57 43 0 151 170 127 127 127 127 
127 127 127 128 127 127 130 127 128 127 195 132 91 91 84 0 0 0 0 44 57 57 43 0 0 108 102 102 102 121 
127 130 127 127 127 127 127 127 127 127 103 0 0 0 0 0 0 0 60 216 65 65 43 0 0 0 0 0 0 180 
127 127 127 110 102 178 178 178 178 178 105 0 0 0 0 0 0 0 0 48 198 214 45 47 155 46 0 0 0 180 
127 127 110 105 0 0 0 0 0 0 0 0 0 150 0 0 0 0 0 0 0 100 82 216 66 43 0 0 125 122 
127 127 103 0 0 0 0 0 0 0 0 0 0 81 0 0 0 0 0 0 0 0 0 48 156 45 144 126 127 127 
110 178 105 0 0 0 0 0 0 0 0 0 107 193 106 0 0 0 0 0 0 0 0 0 0 0 104 127 127 127 
119 0 0 0 0 0 0 0 0 0 0 0 104 127 109 129 106 0 0 0 0 0 0 0 0 0 180 127 128 127 
109 101 106 0 0 0 0 0 0 0 0 0 180 127 127 127 179 0 0 0 0 0 0 0 0 125 122 127 130 127 
127 127 103 0 0 0 0 0 0 0 0 0 180 127 128 127 103 0 0 111 0 0 0 107 126 127 127 127 127 127 
127 127 103 0 0 0 0 0 0 0 0 0 180 127 127 127 109 106 99 88 205 206 0 104 127 128 127 127 127 130 
127 127 141 143 0 0 0 0 0 0 0 125 122 127 127 130 127 109 193 193 225 226 177 142 127 127 127 127 127 127 
127 130 127 109 101 101 101 101 101 101 126 127 127 127 127 127 127 127 127 128 127 127 127 130 127 127 127 128 127 127 
127 127 127 127 127 127 127 127 130 127 127 127 128 127 127 127 127 127 127 127 127 127 127 127 127 127 127 127 127 127 
14 1
0 0
1
5 33 2
1
