20 17
0 0 0 0 0 0 0 0 0 0 0 0 0 0 0 0 0 0 0 0 
0 0 0 0 0 0 0 0 0 0 0 0 0 0 0 0 0 0 0 0 
0 0 0 0 0 0 0 0 0 0 0 0 0 0 0 0 0 0 0 0 
0 0 0 0 0 0 0 0 0 0 0 0 0 0 0 0 0 0 0 0 
0 0 0 0 0 0 0 0 0 0 0 0 0 0 0 0 0 0 0 0 
197 197 197 197 197 197 197 197 197 197 197 197 197 197 197 197 197 46 47 197 
50 42 42 42 42 42 42 42 42 42 42 42 218 218 218 218 214 45 48 51 
219 0 0 0 0 0 0 0 0 0 0 0 0 0 0 0 81 0 0 220 
219 0 0 0 0 0 0 0 0 0 0 0 0 0 0 0 81 0 0 220 
219 0 0 0 0 0 0 0 0 0 0 0 0 0 0 0 81 0 0 220 
219 0 0 0 0 0 0 0 111 0 0 0 0 0 0 0 81 0 0 220 
219 0 0 0 0 0 0 0 81 0 0 0 0 0 0 0 81 0 0 220 
219 0 0 0 0 0 0 0 92 0 0 0 0 0 0 0 0 0 0 220 
219 0 0 0 0 0 0 0 81 0 0 0 0 0 0 0 30 0 0 220 
49 41 41 41 41 41 41 41 213 41 41 41 217 217 217 217 213 41 41 52 
0 0 0 0 0 0 0 0 0 0 0 0 0 0 0 0 0 0 0 0 
0 0 0 0 0 0 0 0 0 0 0 0 0 0 0 0 0 0 0 0 
3
6 22 2
5 22 2
4 22 2
0
