81 14
1 1 1 1 1 1 1 1 6 7 1 1 1 1 1 1 1 1 1 1 1 1 1 1 1 1 1 1 1 1 1 1 1 1 1 1 1 1 1 1 1 1 1 1 1 1 1 1 1 1 1 1 1 1 1 1 1 1 1 1 1 1 1 1 1 1 1 1 1 1 1 1 1 1 1 1 1 1 1 1 1 
10 2 2 2 38 2 238 2 5 8 11 10 2 38 2 36 2 2 2 2 2 36 2 2 36 2 2 2 2 2 2 2 2 2 2 2 2 2 2 2 2 2 2 36 2 2 2 2 2 2 2 2 2 2 2 2 2 2 2 2 2 2 2 2 2 2 38 2 2 2 2 2 2 2 2 2 2 2 2 2 11 
3 0 0 0 131 0 0 0 0 0 4 3 111 131 0 0 0 0 0 0 0 0 0 0 0 0 0 0 0 0 0 0 0 0 0 0 0 0 0 0 0 0 0 0 0 0 0 0 0 0 0 0 0 0 0 0 0 0 0 0 0 0 0 0 0 0 131 0 0 0 0 0 0 0 0 0 0 0 0 0 4 
3 0 7 1 37 1 1 1 1 1 12 9 233 37 1 35 1 1 1 1 1 35 1 1 35 1 1 1 1 1 1 1 1 1 1 1 1 1 1 1 1 1 1 35 1 1 1 1 1 1 1 1 1 1 1 1 1 1 1 1 1 1 1 1 1 1 37 1 1 1 1 1 1 1 1 1 6 0 0 7 12 
3 0 8 2 2 234 234 2 2 11 10 2 2 2 2 2 2 2 2 38 2 2 38 2 2 2 2 2 2 2 2 2 2 2 2 2 2 2 11 17 17 17 17 17 17 17 17 17 17 10 2 2 38 238 238 38 11 10 2 2 238 2 234 234 2 2 2 2 2 238 2 238 2 238 2 238 5 0 0 8 11 
3 0 0 0 0 133 134 0 0 4 3 0 0 0 0 0 0 0 0 131 0 0 131 0 0 0 0 0 0 0 0 0 0 0 0 0 0 0 8 2 2 2 2 2 11 17 17 20 17 235 133 134 131 0 0 131 4 239 0 0 0 99 97 87 80 0 0 0 0 0 0 0 0 0 0 0 0 0 0 0 4 
3 0 0 0 0 135 136 0 0 4 3 0 0 0 0 0 0 0 0 131 0 0 131 0 0 0 0 0 0 0 0 0 0 0 0 0 0 0 7 1 1 1 1 6 4 17 20 18 18 235 135 136 131 0 0 131 4 3 0 0 0 92 0 0 0 0 0 0 0 0 0 0 0 0 0 0 0 0 0 0 4 
3 0 0 0 0 0 0 0 0 4 3 0 0 0 0 0 0 0 0 131 0 0 131 0 0 0 0 0 0 0 0 0 0 0 0 0 0 0 4 17 17 17 17 3 4 17 17 17 17 9 6 0 131 0 0 131 4 239 0 0 0 81 0 113 0 0 0 0 0 0 0 0 0 0 0 0 0 0 0 0 4 
3 0 0 0 0 0 0 0 0 4 3 0 0 0 0 0 0 0 0 131 0 0 131 0 0 0 0 0 0 0 0 0 0 0 0 0 0 15 12 10 2 2 2 5 4 17 18 17 17 17 3 0 131 0 0 131 4 3 0 0 0 81 0 81 0 0 0 0 0 0 0 0 0 0 0 0 0 0 0 0 4 
3 0 0 0 0 0 0 0 0 4 3 0 0 0 0 0 0 0 0 131 0 0 131 0 0 0 0 0 0 0 0 0 0 0 0 24 16 20 17 3 7 1 1 1 12 17 10 2 2 2 5 0 131 0 0 131 4 239 0 0 60 84 0 81 0 0 0 0 0 0 0 0 0 0 0 0 0 0 0 0 4 
3 0 0 0 0 0 0 0 0 4 3 0 0 0 0 0 0 0 0 131 0 0 131 0 0 0 0 0 0 0 0 0 0 0 0 4 17 17 17 3 4 17 17 17 17 17 3 7 1 6 0 0 131 0 0 131 4 3 0 0 0 0 0 81 0 0 0 0 0 0 0 0 0 0 0 0 0 0 0 0 4 
3 0 0 0 0 0 0 0 0 8 5 0 0 0 0 0 0 0 0 131 0 0 131 0 0 0 0 0 0 0 0 0 0 0 0 4 17 17 17 3 8 2 2 2 2 2 5 4 17 3 0 0 131 0 0 131 8 5 0 0 0 0 0 90 132 96 0 0 0 0 0 0 0 0 0 0 0 0 0 0 4 
3 0 0 0 0 0 0 0 0 7 6 0 0 0 0 0 0 0 0 131 7 6 131 0 0 0 0 0 0 7 6 185 186 7 16 17 17 17 17 9 1 1 1 1 1 1 1 12 17 3 0 0 131 0 0 131 7 6 30 0 30 0 0 94 0 0 212 211 211 0 0 0 0 0 0 0 0 0 0 0 4 
9 1 1 1 1 1 1 1 1 12 9 1 1 1 1 1 1 1 1 37 12 9 37 1 1 1 1 1 1 12 9 187 188 12 17 17 17 17 17 17 17 17 17 17 17 17 17 17 17 9 1 1 37 237 237 37 12 9 233 1 233 1 237 233 237 201 232 231 231 1 1 1 1 1 1 1 1 1 1 1 12 
5
14 20 2
74 20 2
79 20 2
69 20 2
26 20 2
0
