48 24
124 0 0 0 0 0 0 0 0 0 0 0 0 0 0 0 0 0 0 0 0 0 0 0 0 0 0 0 107 101 101 101 147 101 129 129 129 101 106 0 0 0 0 0 0 0 0 0 
127 123 143 0 0 0 0 0 0 0 0 0 0 144 143 0 0 0 0 0 0 0 0 0 0 0 125 101 122 127 127 127 127 127 127 127 127 127 109 101 101 101 101 101 101 106 0 0 
127 127 141 143 0 0 0 0 0 0 0 144 101 122 109 143 0 0 0 0 0 0 0 107 101 126 127 127 127 127 127 127 127 127 127 127 127 127 127 127 127 127 127 127 127 109 106 0 
127 127 127 109 106 0 0 0 0 107 149 122 127 127 127 109 129 106 0 0 0 0 144 122 127 127 127 127 127 127 127 127 127 127 127 127 127 127 127 127 127 127 127 127 127 127 109 106 
127 127 127 127 195 82 114 115 132 196 127 127 127 127 127 127 127 109 106 0 0 107 122 127 127 127 110 102 178 178 102 102 102 102 102 102 178 102 121 127 127 127 127 127 127 127 127 109 
127 127 127 110 105 0 0 0 0 108 121 127 127 127 127 127 127 127 195 114 115 196 127 127 127 127 103 0 0 0 0 0 0 0 0 0 0 0 104 127 127 127 127 127 127 127 127 127 
127 127 127 103 0 0 0 0 0 0 108 102 102 168 102 102 102 102 105 0 0 108 102 178 102 102 105 0 0 0 0 0 0 0 0 0 0 0 108 102 102 102 102 178 102 121 127 127 
127 127 127 179 0 0 0 0 0 0 0 0 0 131 0 0 0 0 0 0 0 0 0 0 0 0 0 0 0 0 0 0 0 0 0 0 0 0 0 0 0 0 0 0 0 180 127 127 
127 127 127 103 0 0 0 0 0 0 0 0 0 131 0 0 0 0 0 0 0 0 0 0 0 0 0 0 0 0 0 0 0 0 0 0 0 0 0 0 0 0 0 0 0 104 127 127 
127 127 127 103 0 0 0 0 0 0 0 0 0 131 0 0 0 0 0 0 0 0 0 0 0 0 0 47 41 41 41 197 41 41 155 46 0 0 0 0 0 0 0 0 0 104 127 127 
127 127 127 179 0 0 0 0 0 0 0 0 0 131 0 0 0 0 0 0 0 0 0 0 0 0 0 176 65 65 57 57 57 65 65 43 0 0 0 0 0 0 0 0 0 104 127 127 
127 127 127 103 0 0 107 177 101 101 101 101 101 167 101 101 106 0 0 0 107 101 106 0 0 0 0 44 57 57 57 57 57 57 57 43 0 144 177 177 143 0 0 0 0 104 127 127 
127 127 127 195 114 115 196 127 127 127 127 127 127 127 127 127 103 0 0 0 104 127 103 0 0 0 0 176 65 65 57 57 57 65 65 215 132 196 127 127 195 132 114 115 82 196 127 127 
127 127 127 103 0 0 104 127 127 127 110 168 102 102 102 102 105 0 0 0 104 127 103 0 0 0 0 48 214 214 42 42 42 388 42 45 0 104 127 127 103 0 0 0 0 104 127 127 
127 127 127 179 0 0 104 127 127 127 119 131 0 0 0 0 0 0 0 0 104 127 103 0 0 0 0 0 81 81 0 0 0 0 0 0 0 104 127 127 103 0 0 0 0 104 127 127 
127 127 127 119 0 0 104 127 127 127 179 131 0 0 0 0 0 0 0 0 104 127 103 0 0 144 147 101 193 193 106 0 0 0 0 0 0 104 127 127 103 0 0 0 0 104 127 127 
127 127 127 103 0 0 104 127 127 127 109 167 101 101 101 101 101 101 101 101 122 127 163 116 116 164 127 127 127 127 103 0 0 0 0 0 0 104 127 127 169 77 0 0 0 104 127 127 
127 127 127 195 114 115 196 127 127 127 127 127 127 127 127 127 127 127 127 127 127 127 103 0 0 104 127 127 127 127 103 0 0 0 0 0 0 108 102 102 105 0 0 0 0 104 127 127 
127 127 127 103 0 0 108 102 102 102 102 102 102 102 102 102 102 102 102 102 102 102 105 0 0 108 178 102 102 178 105 0 0 0 0 0 0 0 0 0 0 0 0 111 0 104 127 127 
127 127 127 103 0 0 0 0 0 0 0 0 0 0 0 0 0 0 0 0 0 0 0 0 0 0 0 0 0 0 0 0 0 0 0 0 0 0 0 0 0 0 0 100 95 196 127 127 
127 127 127 103 0 0 0 0 0 0 0 0 0 125 101 101 101 101 124 0 0 150 0 0 0 0 0 0 0 0 0 0 0 0 0 0 0 0 0 0 0 0 0 0 0 104 127 127 
127 127 127 103 0 0 0 0 0 0 0 125 126 127 127 127 127 127 127 123 101 193 101 101 101 101 101 101 124 0 0 0 0 0 0 0 0 0 0 0 0 0 0 0 0 104 127 127 
127 127 127 141 101 101 101 101 101 101 126 127 127 127 127 127 127 127 127 127 127 127 127 127 127 127 127 127 127 123 101 101 101 101 101 101 101 101 101 101 101 101 101 101 101 122 127 127 
127 127 127 127 127 127 127 127 127 127 127 127 127 127 127 127 127 127 127 127 127 127 127 127 127 127 127 127 127 127 127 127 127 127 127 127 127 127 127 127 127 127 127 127 127 127 127 127 
14 0
0 2
0 1
14 0
0 1
2
34 29 3
6 29 3
1
