32 40
0 0 0 0 0 0 0 0 0 0 0 0 0 0 0 0 0 0 0 0 0 0 0 0 0 0 0 0 0 0 0 0 
0 185 186 0 0 0 0 0 0 0 0 0 0 0 0 0 0 0 0 0 0 0 0 0 0 0 0 0 0 0 0 0 
1 187 188 1 28 6 0 0 0 0 0 0 0 0 0 0 0 0 0 0 0 0 0 0 0 0 0 0 15 1 19 1 
17 17 17 20 10 5 0 0 0 0 0 0 0 0 0 0 0 0 0 7 28 1 19 19 19 1 1 16 17 17 17 17 
17 17 17 17 3 0 0 0 0 0 0 0 0 0 0 0 0 0 0 4 17 18 17 17 20 17 17 17 20 17 17 18 
17 18 17 17 3 0 0 0 0 0 0 0 0 0 0 0 0 0 0 4 17 17 17 17 17 17 17 17 17 18 17 17 
17 17 17 17 9 6 0 0 0 0 0 0 0 0 0 0 0 0 0 8 2 2 11 17 17 18 17 17 17 17 17 17 
17 17 17 17 17 3 0 0 0 0 0 0 0 0 0 0 0 0 0 0 0 0 8 2 2 2 2 2 2 2 11 17 
17 17 20 17 18 9 6 0 0 0 0 0 0 0 0 0 0 0 0 0 0 0 0 0 0 0 0 0 0 0 4 17 
17 17 17 17 17 17 3 0 0 0 0 0 0 0 0 0 0 0 0 0 0 0 0 7 1 27 1 19 6 0 4 20 
17 17 17 17 17 17 3 0 0 0 0 0 0 0 0 0 0 0 0 0 0 0 0 4 18 17 17 17 33 116 34 17 
17 17 17 18 17 17 9 6 0 0 0 0 0 0 0 0 0 0 0 0 0 0 24 12 17 10 2 2 5 0 4 17 
17 17 17 17 17 17 17 3 0 0 0 0 0 0 0 0 0 0 0 0 0 0 4 17 17 3 0 0 0 0 4 17 
17 18 18 17 17 20 17 21 14 0 0 0 0 0 0 0 0 0 0 0 0 0 4 17 18 3 0 7 27 1 12 17 
17 17 17 17 17 17 17 17 17 13 23 0 0 0 0 0 0 0 0 0 0 0 4 17 17 33 116 34 17 17 17 17 
17 10 238 2 2 2 2 11 17 17 21 6 0 0 0 0 0 0 0 0 0 24 12 17 17 3 0 4 17 17 17 17 
17 3 0 0 0 0 0 4 18 17 17 3 0 0 0 0 0 0 0 0 24 22 17 17 17 3 0 4 17 18 17 17 
17 3 0 0 0 0 0 4 17 20 17 3 0 0 0 0 0 0 0 15 12 17 20 17 17 33 116 34 17 17 18 17 
17 3 0 0 0 111 0 4 17 17 17 3 0 0 0 0 0 24 16 17 17 17 17 18 17 39 77 4 17 17 17 17 
17 3 0 0 0 92 0 4 17 17 18 21 27 1 19 27 1 12 17 18 17 17 17 17 17 3 0 4 17 17 17 17 
17 3 0 0 7 233 19 12 17 17 17 17 17 20 17 17 17 17 17 17 17 17 17 20 17 33 116 34 17 18 17 17 
346 386 0 0 366 346 346 346 346 346 346 346 346 346 346 346 346 346 346 346 346 346 346 346 346 386 0 366 346 346 346 346 
57 175 0 86 216 65 57 57 57 57 57 57 57 57 57 57 57 57 57 57 57 57 57 57 65 43 0 44 65 57 57 57 
57 43 0 81 48 68 42 198 42 42 42 42 42 42 42 214 214 218 42 42 42 218 218 42 42 45 0 48 69 42 51 57 
57 43 0 81 0 0 0 0 0 0 0 0 0 0 0 100 97 0 0 0 0 0 0 0 0 0 0 0 0 0 176 57 
57 43 0 87 114 115 85 0 0 0 0 0 0 0 0 0 0 0 99 96 0 0 0 0 0 0 0 86 114 115 216 57 
57 43 0 0 0 47 213 41 41 41 41 41 41 41 41 41 41 197 213 41 41 41 41 41 217 41 41 213 46 0 44 57 
57 43 0 0 0 44 57 57 57 57 57 57 65 65 65 65 65 65 65 65 65 65 65 65 57 57 57 57 43 0 44 57 
57 43 0 0 0 44 57 57 57 57 57 57 57 57 57 57 57 57 57 57 57 57 57 57 57 57 57 57 43 0 44 57 
57 175 0 0 0 44 57 57 57 57 57 57 57 57 57 57 57 57 57 57 57 57 57 57 57 57 57 57 43 0 44 57 
57 43 0 0 0 44 57 57 57 57 57 50 42 42 42 42 42 42 42 42 42 42 42 138 51 57 57 57 43 0 44 57 
57 43 0 0 0 44 57 57 57 57 57 43 0 0 0 0 0 0 0 0 0 0 0 0 44 57 57 57 43 0 44 57 
57 43 0 0 0 44 57 57 57 57 57 43 0 0 0 0 0 0 0 0 0 0 0 0 44 57 57 57 43 0 44 57 
57 43 0 0 0 44 65 65 65 65 65 43 0 0 0 0 0 0 0 0 0 0 0 0 44 65 65 65 43 0 44 57 
57 43 0 0 0 44 65 65 65 65 65 43 0 0 0 0 0 0 0 0 0 0 0 0 44 65 65 65 43 0 44 57 
57 43 0 0 0 48 68 42 42 42 42 45 0 0 0 0 0 0 0 0 0 0 0 0 48 42 42 69 45 0 44 57 
57 43 0 0 0 0 0 0 0 0 0 0 0 0 0 0 0 0 0 0 0 0 0 0 0 0 0 0 0 0 44 57 
57 61 41 41 41 41 41 41 41 41 41 41 41 41 41 387 41 41 41 387 41 41 41 41 41 41 41 41 41 217 52 57 
57 57 57 57 57 57 57 57 57 57 57 57 57 57 57 57 57 57 57 57 57 57 57 57 57 57 57 57 57 57 57 57 
57 57 57 57 57 57 57 57 57 57 57 57 57 57 57 57 57 57 57 57 57 57 57 57 57 57 57 57 57 57 57 57 
14 0
0 1
0
0
