64 32
0 0 0 0 0 0 0 0 0 0 0 0 0 0 0 0 0 0 0 0 0 0 0 0 0 0 0 0 0 0 0 0 0 0 0 0 0 0 0 0 0 0 0 0 0 0 0 0 0 0 0 0 0 0 0 0 0 0 0 0 0 0 0 0 
0 0 0 0 0 0 0 0 0 0 0 0 223 0 0 0 0 0 0 0 0 0 0 0 0 0 0 223 0 0 0 0 0 0 0 0 223 0 0 0 0 0 0 0 0 0 0 0 0 0 0 223 0 0 0 0 0 0 0 0 0 0 0 0 
0 0 0 0 0 0 0 0 47 387 41 41 224 41 41 41 41 41 41 41 41 41 41 41 387 41 41 224 41 41 41 41 41 41 41 41 224 41 41 387 41 41 41 41 41 41 41 41 41 41 41 224 41 41 387 46 0 0 0 0 0 0 0 0 
0 0 0 0 0 0 0 0 44 65 65 57 57 57 57 65 65 65 65 65 57 57 57 57 57 57 57 57 57 57 57 57 57 65 65 65 65 57 57 57 57 57 65 50 42 42 42 42 42 42 42 42 42 42 68 45 0 0 0 0 0 0 0 0 
0 0 0 0 0 0 0 0 44 57 57 57 57 57 57 50 42 218 42 51 57 57 57 57 57 57 57 57 57 57 57 57 57 57 57 57 57 57 57 57 57 57 57 43 0 0 0 0 0 0 0 0 0 0 0 0 0 0 0 0 0 0 0 0 
0 0 0 0 0 0 0 0 44 57 57 57 57 57 57 43 0 0 0 44 57 57 57 57 57 57 57 57 57 57 57 57 57 57 57 57 57 57 57 57 57 57 57 219 0 0 0 0 0 0 0 0 0 0 0 0 0 0 0 0 0 0 0 0 
0 0 0 0 0 0 0 0 44 57 57 57 57 57 57 43 0 0 0 44 57 57 57 57 57 57 57 57 57 57 57 57 57 57 57 57 57 57 57 57 57 57 57 43 0 0 47 41 41 197 41 41 197 41 41 46 0 0 0 0 0 0 0 0 
0 0 0 0 0 0 0 0 44 57 57 57 57 57 57 175 0 0 0 176 57 57 57 57 57 57 57 57 57 57 57 57 57 65 65 65 65 57 57 57 57 57 65 215 114 115 216 65 65 57 57 57 57 65 65 43 0 0 0 0 0 0 0 0 
0 0 0 0 0 0 0 0 44 57 57 57 57 57 57 43 0 0 0 44 57 57 57 57 57 57 57 57 57 57 57 57 50 42 42 42 42 42 42 42 42 42 198 45 0 0 44 65 65 57 57 57 57 65 65 43 0 0 0 0 0 0 0 0 
0 0 0 0 0 0 0 0 44 57 57 57 57 57 57 43 0 0 0 44 57 57 57 57 57 57 57 57 57 57 57 57 43 0 0 0 0 0 0 0 0 0 0 0 0 0 44 57 57 57 57 57 57 57 57 43 0 0 0 0 0 0 0 0 
0 0 0 0 0 0 0 0 44 57 57 57 57 57 57 43 0 0 0 44 57 57 57 57 57 57 57 57 57 57 57 57 175 0 0 0 0 0 0 0 0 0 0 0 0 0 44 57 57 57 57 57 57 57 57 43 0 0 0 0 0 0 0 0 
0 0 0 0 0 0 0 0 44 57 57 57 57 57 57 43 0 0 0 44 57 57 57 57 57 57 57 57 57 57 57 57 43 0 0 0 0 0 0 0 0 0 0 0 0 0 220 57 57 57 57 57 57 57 57 43 0 0 0 0 0 0 0 0 
0 0 0 0 0 0 0 0 44 57 57 57 57 65 65 43 0 0 0 44 65 65 57 57 57 57 57 57 57 57 57 57 43 0 0 0 0 47 41 41 41 41 41 46 0 0 44 57 57 57 57 57 57 57 57 43 0 0 0 0 0 0 0 0 
0 0 0 0 0 0 0 0 44 57 57 57 50 42 68 45 0 0 0 48 69 42 42 42 42 42 42 42 42 42 42 68 45 0 0 0 0 44 65 57 57 57 57 215 114 115 216 65 65 57 57 57 57 65 65 43 0 0 0 0 0 0 0 0 
0 0 0 0 0 0 0 0 44 57 57 57 43 0 0 0 0 0 0 0 0 0 0 0 0 0 0 0 0 0 0 0 0 0 0 0 0 44 57 57 57 57 57 43 0 0 44 65 65 57 57 57 57 65 65 43 0 0 0 0 0 0 0 0 
0 0 0 0 0 0 0 0 44 57 57 57 43 0 0 0 0 0 0 0 0 0 0 0 0 0 0 0 0 0 0 0 0 0 0 0 0 44 57 57 57 57 57 43 0 0 44 57 57 57 57 57 57 57 57 43 0 0 0 0 0 0 0 0 
0 0 0 0 0 0 0 0 44 57 57 57 43 0 0 0 0 0 0 0 0 0 0 0 0 0 0 0 0 0 0 0 0 0 0 0 0 44 57 57 57 57 57 43 0 0 44 57 57 57 57 57 57 57 57 43 0 0 0 0 0 0 0 0 
0 0 0 0 0 0 0 0 44 57 57 57 43 0 0 0 0 0 0 0 0 0 0 0 0 0 0 0 0 0 0 0 0 0 0 0 0 44 57 57 57 57 57 43 0 0 48 42 42 42 42 42 42 42 68 45 0 0 0 0 0 0 0 0 
0 0 0 0 0 0 0 0 44 57 57 57 43 0 0 47 41 41 41 41 41 41 217 41 41 217 41 41 217 46 0 0 0 0 0 0 0 44 57 57 57 57 57 199 0 0 0 0 0 0 0 0 0 0 0 0 0 0 0 0 0 0 0 0 
0 0 0 0 0 0 0 0 44 57 57 57 43 0 0 48 214 198 198 198 198 198 198 198 198 198 198 198 214 45 0 0 0 0 0 0 0 44 57 57 57 57 57 43 0 0 0 0 0 0 0 0 0 0 0 0 0 0 0 0 0 0 0 0 
0 0 0 0 0 0 0 0 44 57 57 57 43 0 111 0 423 116 116 116 116 116 116 116 116 116 116 116 424 0 0 0 0 0 0 0 0 44 57 57 57 57 57 43 0 0 0 0 0 0 0 0 0 0 0 0 0 0 0 0 0 0 0 0 
0 0 0 0 0 0 0 0 44 57 57 57 43 0 94 0 81 0 47 56 53 56 53 56 53 56 53 46 87 96 0 0 0 0 0 0 0 44 57 57 57 57 57 43 0 0 0 0 0 0 0 0 0 0 0 0 0 0 0 0 0 0 0 0 
0 0 0 0 0 0 0 0 44 57 57 57 49 41 213 41 213 137 62 57 57 57 57 57 57 57 57 49 41 41 41 41 41 41 41 41 41 62 57 57 57 57 57 61 41 41 155 41 41 41 41 41 41 155 41 46 0 0 0 0 0 0 0 0 
0 0 0 0 0 0 0 0 44 57 57 57 57 65 65 65 57 57 57 57 57 57 57 57 57 57 57 57 57 57 57 57 57 57 57 57 57 57 57 57 57 57 57 57 57 57 57 57 57 57 57 57 57 57 57 43 0 0 0 0 0 0 0 0 
0 0 0 0 0 0 0 0 44 57 57 57 57 57 57 57 57 57 57 57 57 57 57 57 57 57 57 57 57 57 57 57 57 57 57 57 57 57 57 57 57 57 57 57 57 57 57 57 57 57 57 57 57 57 57 43 0 0 0 0 0 0 0 0 
0 0 0 0 0 0 0 0 44 57 57 57 57 57 57 57 57 57 57 57 57 57 57 57 57 57 57 57 57 57 57 57 57 57 57 57 57 57 57 57 57 57 57 57 57 57 57 57 57 57 57 57 57 57 57 43 0 0 0 0 0 0 0 0 
0 0 0 0 0 0 24 72 52 57 57 57 57 57 57 57 57 57 57 57 57 57 57 57 57 57 57 57 57 57 57 57 57 57 57 57 57 57 57 57 57 57 57 57 57 57 57 57 57 57 57 57 57 57 57 49 73 14 0 0 0 0 0 0 
0 0 0 0 0 0 4 74 75 75 75 75 75 75 75 75 75 75 75 75 75 75 75 75 75 75 75 75 75 75 75 75 75 75 75 75 75 75 75 75 75 75 75 75 75 75 75 75 75 75 75 75 75 75 75 75 76 17 13 14 0 0 0 0 
0 185 186 0 0 0 4 20 17 17 17 17 17 17 17 17 17 20 17 17 17 17 17 17 18 17 17 17 17 17 20 17 17 17 20 17 17 17 17 17 17 17 17 17 17 17 18 17 17 17 17 17 17 17 20 17 17 18 17 17 13 14 0 0 
1 187 188 1 1 27 12 17 17 18 17 17 17 20 17 17 17 17 17 17 17 17 17 17 17 17 17 17 17 17 17 17 17 17 17 17 17 17 17 17 17 17 17 17 17 17 17 17 17 17 17 17 17 17 17 17 17 17 17 17 20 17 13 14 
17 20 17 17 17 18 17 17 17 17 17 17 17 17 17 17 17 20 17 17 17 17 17 17 17 17 17 17 17 17 17 17 17 17 18 17 17 17 17 17 17 17 18 17 17 17 17 17 17 17 17 17 18 17 17 17 17 17 18 17 17 17 17 17 
17 17 17 20 17 17 20 17 17 17 17 17 17 17 18 17 17 17 17 17 17 17 17 17 17 20 17 17 17 17 17 17 17 17 17 17 17 17 17 17 17 17 17 17 17 17 17 17 17 17 17 17 17 17 17 17 17 17 17 17 17 17 17 20 
14 0
0 1
0
2
