96 32
147 101 143 0 0 0 0 0 0 0 0 0 0 0 0 0 0 0 0 0 0 0 0 0 0 0 0 0 0 0 0 0 0 0 0 0 0 0 0 0 0 0 0 0 0 0 0 0 0 0 0 0 0 0 0 0 0 0 0 0 0 0 0 0 107 106 0 0 0 0 0 0 0 0 0 0 0 0 0 0 0 0 0 0 0 0 0 0 0 0 0 0 0 0 0 0 
127 127 141 101 106 0 0 0 0 0 0 0 107 101 101 147 101 106 0 107 101 101 101 106 0 0 0 0 0 0 0 0 0 0 0 0 0 0 0 0 0 0 0 0 0 0 0 0 0 0 0 0 0 0 0 0 0 144 106 0 0 0 0 107 122 103 0 0 0 0 107 143 0 0 0 0 0 0 0 0 0 0 0 0 0 0 0 0 0 0 0 0 0 0 0 0 
127 128 127 127 141 101 101 143 0 0 107 101 122 127 128 127 127 141 129 122 127 127 127 109 106 0 0 0 0 0 0 0 0 0 0 0 0 0 0 0 0 0 0 0 0 0 0 0 0 0 0 0 0 0 0 0 144 122 195 82 114 115 132 196 127 195 132 114 115 82 196 141 129 101 106 0 0 0 0 0 0 0 0 0 0 107 147 101 143 0 0 0 0 0 0 144 
127 127 127 127 127 130 127 141 101 101 122 127 130 127 110 178 102 178 102 178 121 127 128 127 103 0 0 0 0 0 0 0 0 0 0 0 0 0 0 0 0 0 0 0 0 0 0 0 0 0 0 0 0 0 0 0 104 110 105 0 0 0 0 104 110 105 0 0 0 107 122 127 127 130 141 101 143 0 0 0 0 107 101 129 147 122 127 127 141 101 106 0 0 0 0 104 
127 127 127 127 127 127 127 127 127 128 127 110 102 178 105 0 0 0 0 0 108 121 127 127 109 106 0 0 0 0 0 107 143 0 0 0 0 0 0 0 0 0 0 0 0 0 0 0 0 0 0 0 0 0 0 144 142 103 0 0 0 0 107 142 179 0 0 0 0 104 127 127 127 127 127 127 141 101 101 101 101 122 130 127 127 127 127 128 127 127 141 143 0 0 144 122 
127 127 127 127 127 127 127 127 110 102 178 105 0 0 0 0 0 0 0 0 0 108 121 127 127 109 101 106 0 0 0 104 109 143 0 0 0 0 0 0 0 0 0 0 0 144 207 208 106 0 0 0 0 0 144 142 127 103 0 0 0 107 142 128 103 0 0 0 107 142 127 127 128 127 127 127 127 127 127 127 127 127 127 127 127 127 127 127 127 127 127 141 147 129 122 130 
127 127 127 127 127 128 110 178 105 0 0 0 0 0 0 0 0 0 0 0 0 0 180 127 130 127 127 103 0 0 0 104 127 141 143 0 0 0 0 0 0 0 0 0 0 104 227 228 103 0 0 0 0 144 142 127 127 103 0 0 0 108 121 127 163 116 116 116 164 127 127 127 127 127 127 127 130 127 127 127 127 127 127 127 127 127 127 127 127 127 127 127 127 127 127 127 
127 128 127 110 102 178 105 0 0 0 0 0 0 0 0 0 0 0 0 0 0 107 122 127 127 127 128 109 101 129 147 122 127 127 103 0 0 0 0 0 0 0 0 144 101 122 127 128 103 0 0 0 144 142 127 127 110 105 0 0 0 0 108 121 103 0 0 0 104 127 127 127 127 127 127 127 127 127 127 127 127 127 127 127 127 127 127 127 127 130 127 127 127 127 127 127 
127 127 127 103 0 0 0 0 0 0 0 0 0 0 0 0 0 0 0 0 0 180 127 127 127 127 127 127 127 130 127 127 127 127 103 0 0 0 0 0 0 0 144 122 127 127 127 127 109 101 129 147 142 127 127 127 103 0 0 0 0 0 0 104 103 0 0 107 122 130 127 127 127 127 127 127 127 127 127 128 130 127 127 127 127 127 110 102 102 102 194 102 121 127 128 127 
127 130 110 105 0 0 0 0 0 0 0 0 0 0 0 0 0 0 0 0 107 122 127 128 127 127 127 127 127 127 127 127 127 127 141 143 0 0 0 0 0 0 104 127 127 127 127 127 127 127 127 127 127 127 127 127 103 0 0 0 0 0 0 104 103 0 0 108 102 121 127 127 127 128 127 110 102 102 121 127 110 102 102 102 194 102 105 0 0 0 81 0 108 102 102 194 
127 127 179 0 0 0 0 0 0 0 0 0 0 0 0 0 0 0 0 0 180 127 127 127 127 127 127 127 110 102 102 102 121 128 127 141 101 147 101 147 101 101 142 127 127 127 127 127 127 127 127 127 127 127 127 127 163 116 116 116 116 116 116 164 179 0 0 0 0 108 121 127 127 127 110 105 0 0 108 194 105 0 0 0 81 0 0 0 0 0 94 0 0 0 0 81 
127 127 103 0 0 0 0 0 0 0 0 0 0 0 0 0 0 0 0 0 180 127 127 127 127 127 110 102 105 0 0 0 108 178 102 121 127 127 127 127 128 127 127 110 102 102 102 178 102 121 127 127 127 128 127 127 103 0 0 0 0 0 0 104 103 0 0 0 0 0 108 121 127 127 103 0 0 0 0 87 82 82 132 82 88 0 0 86 82 132 91 98 0 0 0 81 
128 110 105 0 0 0 0 0 0 0 0 0 0 0 0 0 0 0 0 0 108 121 127 127 127 110 105 0 0 0 0 0 0 0 0 108 102 102 121 127 127 110 102 105 0 0 0 0 0 108 102 102 102 121 127 127 109 106 0 0 0 0 107 122 109 148 106 0 0 0 0 104 127 110 105 0 0 0 0 0 0 0 0 0 94 0 0 81 0 0 0 81 0 0 0 81 
127 103 0 0 0 0 0 0 0 0 0 0 0 0 0 0 0 0 0 0 0 180 127 127 110 105 0 0 0 0 0 0 0 0 0 0 0 0 108 178 102 105 0 0 0 0 0 0 0 0 0 0 0 104 127 127 127 103 0 144 101 148 142 128 127 127 109 106 0 0 0 104 127 103 0 0 86 98 0 99 82 95 85 0 87 82 82 84 0 0 0 87 132 82 82 83 
127 179 0 0 0 0 0 0 0 0 0 0 0 0 0 0 0 0 0 0 0 120 127 127 103 0 0 0 0 0 0 0 0 0 0 0 0 0 0 0 0 0 0 0 0 0 0 0 0 0 0 0 0 108 121 127 127 103 0 108 102 102 121 127 127 127 110 105 0 0 0 104 127 103 0 0 94 81 0 81 0 0 81 0 0 0 0 0 0 0 0 0 0 0 0 81 
127 103 0 0 0 0 0 0 0 0 0 0 0 0 0 0 0 0 0 0 0 180 127 130 103 0 0 0 0 0 0 0 0 0 0 0 0 0 0 0 0 0 0 0 0 0 0 0 0 0 0 0 0 0 108 121 127 109 106 0 0 0 104 127 127 110 105 0 0 0 107 122 127 195 82 132 91 84 0 81 0 0 90 132 85 0 0 0 0 0 0 0 0 0 0 81 
127 179 0 0 0 0 0 0 0 0 0 0 0 0 0 0 0 0 0 0 0 180 127 110 105 0 0 0 0 0 0 0 0 0 107 101 147 106 0 0 0 0 0 0 0 107 129 106 0 0 0 0 0 0 0 104 127 128 169 77 0 0 108 121 127 103 0 0 0 0 108 121 130 109 106 0 0 0 0 87 82 82 91 82 84 0 0 86 82 82 95 82 82 85 0 81 
127 109 106 0 0 0 0 0 0 0 0 0 0 0 0 0 0 0 0 0 107 122 127 103 0 0 0 0 0 0 0 107 129 101 122 127 127 109 101 106 0 0 0 107 101 122 127 109 129 106 0 0 0 0 0 108 121 127 109 101 106 0 0 104 127 179 0 0 0 0 0 108 121 127 103 0 0 0 0 0 0 0 0 0 0 0 0 81 0 0 0 0 0 81 0 81 
127 130 103 0 0 0 0 0 0 0 0 0 0 0 0 0 0 0 0 0 180 127 127 103 0 0 0 0 0 0 107 122 127 127 127 127 127 128 127 195 132 114 115 196 130 127 127 128 127 109 106 0 0 0 0 0 104 127 127 110 105 0 0 104 127 103 0 0 0 0 0 0 104 127 195 82 82 89 82 82 85 0 99 95 82 85 0 81 0 99 95 85 0 81 0 81 
127 127 103 0 0 0 0 0 0 0 0 107 147 101 177 101 177 106 0 0 104 127 110 105 0 0 0 0 0 0 104 127 130 127 127 127 110 178 102 105 0 0 0 108 102 178 121 127 127 127 109 106 0 0 0 0 104 127 110 105 0 0 0 180 127 141 106 0 0 0 0 0 104 110 105 0 0 81 86 85 81 0 87 82 82 97 0 81 0 90 89 88 0 81 0 94 
127 127 103 0 0 0 0 107 177 101 177 122 127 127 127 110 194 105 0 0 104 127 103 0 0 0 0 0 0 0 104 127 127 127 128 110 105 0 0 0 0 0 0 0 0 0 108 102 102 121 127 103 0 0 0 0 108 121 103 0 107 101 101 122 127 127 141 101 106 0 0 107 122 103 0 0 0 81 81 94 81 0 0 0 0 0 0 81 0 87 91 91 82 97 0 81 
127 127 103 0 0 0 107 122 130 127 127 127 127 128 127 195 133 134 0 107 122 127 179 0 0 0 0 0 0 0 108 121 127 110 102 105 0 0 0 0 0 0 0 0 0 0 0 0 0 104 127 163 116 116 116 116 116 164 103 0 108 102 121 127 127 110 102 102 105 0 0 108 168 105 0 0 0 90 91 91 91 82 82 82 82 85 0 81 0 0 0 0 0 0 0 81 
127 127 103 0 0 0 104 127 127 127 127 127 127 127 127 195 135 136 0 104 127 127 109 106 0 0 0 0 0 0 0 104 127 103 0 0 0 0 0 0 0 0 0 0 0 0 0 0 0 104 130 103 0 0 0 0 0 104 169 77 0 0 108 121 110 105 0 0 0 0 0 0 131 0 0 0 0 87 82 82 82 82 95 82 82 84 0 87 95 82 82 132 82 85 0 81 
127 127 141 106 0 0 104 127 127 127 127 128 127 127 110 105 0 0 107 122 127 130 110 105 0 0 0 0 0 0 0 104 127 103 0 0 0 0 0 0 0 0 0 0 0 0 0 0 0 108 121 109 106 0 0 0 0 104 109 106 0 0 0 108 105 0 0 0 0 0 0 0 131 0 0 0 0 0 0 0 0 0 0 0 0 0 0 0 0 0 0 0 0 94 0 81 
127 127 127 103 0 0 104 127 127 127 127 127 127 127 109 129 129 129 122 127 127 127 103 0 0 0 0 0 0 0 0 104 130 103 0 0 0 0 0 0 0 0 0 0 0 0 0 0 0 0 104 127 179 0 0 0 0 104 128 103 0 0 0 0 0 0 0 0 0 0 0 0 131 0 0 0 0 86 82 132 82 82 82 85 0 86 95 89 82 89 82 82 82 84 0 87 
127 128 127 169 77 151 170 127 128 127 127 127 127 127 128 127 127 127 127 127 110 102 105 0 0 0 0 0 0 0 0 104 127 103 0 0 0 0 0 0 0 0 0 0 0 0 0 0 0 0 104 128 103 0 0 0 0 104 127 103 0 0 0 0 0 0 0 0 0 0 0 0 131 0 0 0 0 81 0 0 0 0 0 81 0 81 0 81 0 94 0 0 0 0 0 0 
127 127 127 103 0 0 104 127 127 127 127 130 127 127 127 127 127 127 110 102 105 0 0 0 0 0 0 0 0 0 0 104 127 169 77 0 0 0 0 0 0 0 0 0 0 0 0 0 0 0 104 127 103 0 0 0 0 108 168 105 0 0 0 0 0 0 0 0 0 0 0 0 131 0 0 0 0 90 89 82 95 82 82 97 0 87 132 97 0 81 0 0 0 0 0 0 
127 127 127 109 106 0 108 102 121 127 110 102 102 168 102 102 121 127 103 0 0 0 0 0 0 0 0 0 0 0 107 122 127 119 0 0 0 0 0 0 0 0 0 0 0 0 0 0 0 144 122 127 109 106 0 0 0 0 131 0 0 0 0 0 0 0 0 0 0 0 0 0 131 0 0 0 0 87 88 0 0 0 0 0 0 0 0 0 0 81 0 0 0 0 0 0 
127 127 130 127 169 77 0 0 108 102 105 0 0 131 0 0 104 110 105 0 0 0 0 0 0 0 0 0 0 0 104 127 127 109 106 0 0 0 0 0 0 0 0 0 0 0 0 125 101 122 127 127 127 103 0 0 0 0 131 0 0 0 0 0 0 0 0 0 0 0 0 0 131 0 0 0 0 0 94 0 0 0 0 86 82 82 95 82 82 88 0 0 0 0 111 0 
127 127 127 127 141 129 106 0 0 0 0 107 129 167 106 0 108 105 0 144 143 0 0 0 0 0 0 0 0 0 104 127 128 127 109 106 0 0 0 0 0 0 0 0 0 125 126 127 127 127 127 127 130 109 106 0 0 0 131 0 0 205 206 0 144 147 143 0 0 0 0 0 131 0 0 0 0 0 90 82 82 82 132 88 0 107 101 106 0 94 0 0 0 0 81 0 
127 127 127 128 127 127 109 129 101 147 101 122 127 128 109 143 0 144 101 142 141 101 177 106 189 190 0 189 190 107 122 127 127 127 127 109 101 101 101 101 101 101 101 101 126 127 127 127 127 128 127 127 127 127 109 207 208 101 167 101 101 225 226 101 122 127 109 129 101 101 143 0 131 0 0 0 0 0 81 107 101 101 101 193 101 122 128 103 0 81 0 205 206 0 94 0 
127 127 127 127 127 127 127 127 127 130 127 127 127 127 127 141 147 122 127 127 127 130 127 141 191 192 101 191 192 122 127 127 127 127 127 127 127 127 127 127 127 128 127 127 127 127 127 127 127 127 127 127 127 127 127 227 228 127 127 128 127 127 127 130 127 127 127 127 127 128 141 101 167 101 101 101 101 101 193 122 127 130 127 127 127 127 127 109 101 193 101 225 226 101 193 101 

0 2
14 0
0 1

1
40 35 2

1
