32 16
13 14 0 0 0 0 0 0 0 0 0 0 0 0 0 0 0 0 0 0 0 0 0 0 0 0 0 0 0 0 15 16 
17 17 13 14 0 0 0 0 0 0 0 0 0 0 0 0 0 0 0 0 0 0 0 0 0 0 0 0 15 16 17 17 
17 20 17 17 13 14 0 0 0 0 0 0 0 0 0 0 0 0 0 0 0 0 0 0 0 0 15 16 17 17 17 17 
17 17 17 17 17 17 13 14 0 0 0 0 0 0 0 0 0 0 0 0 0 0 0 0 15 16 17 17 17 17 17 17 
17 17 17 18 17 17 17 17 13 6 0 0 0 0 0 0 0 0 0 0 7 1 1 16 17 17 20 17 17 18 17 17 
17 17 17 17 17 18 17 17 17 3 0 0 0 0 0 0 0 0 0 0 4 17 17 17 17 17 17 17 17 17 17 17 
17 17 17 17 17 17 17 17 17 3 0 0 0 0 0 0 0 0 0 0 4 17 18 17 17 17 17 20 17 17 17 17 
17 18 17 17 17 17 17 17 17 3 0 0 0 0 0 0 0 0 0 0 4 17 17 17 17 17 17 17 17 17 17 17 
17 17 17 17 17 17 17 20 17 3 0 0 0 0 0 0 0 0 0 0 4 17 17 17 17 18 17 17 17 17 17 17 
17 17 20 17 17 17 17 17 17 9 23 0 0 0 0 0 0 0 0 0 4 17 20 17 17 17 17 17 17 18 17 17 
17 17 17 17 17 18 17 17 17 17 21 23 0 0 111 0 0 7 28 1 12 17 17 17 17 17 17 17 17 17 17 17 
17 17 17 17 17 17 17 17 17 20 17 21 23 0 94 0 0 4 17 17 17 17 17 17 17 17 17 17 17 17 17 20 
17 17 17 17 17 17 17 17 17 17 17 17 9 1 233 1 1 12 17 17 17 17 17 17 18 17 17 17 17 17 17 17 
17 17 18 17 17 17 17 17 18 17 17 17 17 17 17 17 17 17 17 17 18 17 17 17 17 17 17 17 17 17 17 17 
17 17 17 17 17 20 17 17 17 17 17 17 17 17 18 17 17 17 17 17 17 17 17 17 17 17 17 20 17 18 17 17 
17 17 17 17 17 17 17 17 17 17 17 20 20 17 17 17 17 17 17 17 17 17 17 17 20 17 17 17 17 17 17 17 

0

0
