48 32
0 0 0 0 0 0 0 0 0 0 0 0 0 0 0 0 0 0 0 0 0 0 0 0 24 1 19 1 27 23 0 0 0 0 0 0 0 0 0 0 0 0 0 0 0 0 15 16 
86 82 114 115 82 93 82 82 93 82 82 85 0 0 24 221 222 23 0 0 0 0 0 24 12 17 17 20 17 9 19 23 0 0 0 24 19 14 0 7 27 6 0 0 7 16 17 17 
81 0 0 0 0 0 0 0 0 0 0 81 7 28 22 17 17 21 6 185 186 7 1 22 17 17 17 17 17 18 17 21 221 222 27 12 17 17 13 12 17 235 114 115 236 17 18 17 
81 0 0 0 0 0 0 0 0 0 0 94 4 17 20 17 17 17 9 187 188 22 18 17 17 17 17 17 17 17 17 17 17 20 17 17 17 17 17 18 17 3 0 0 4 20 17 17 
87 82 85 0 0 0 30 0 0 0 24 233 22 17 17 18 17 17 17 17 17 17 17 17 17 17 17 17 17 17 17 17 17 17 17 17 18 17 17 17 20 3 0 0 4 17 17 17 
0 0 92 0 0 0 90 82 114 115 236 17 17 17 17 17 17 17 17 17 17 17 17 17 17 17 17 17 17 17 17 17 17 17 17 17 17 17 17 17 17 3 0 0 8 11 17 17 
13 23 81 0 0 7 233 6 0 0 4 17 18 17 17 17 17 10 2 2 11 17 10 2 2 11 17 17 17 17 17 17 17 17 17 17 17 17 17 17 17 239 0 0 0 4 17 17 
18 235 97 0 0 4 17 3 0 0 4 17 17 17 17 17 10 5 0 0 8 234 5 0 0 4 17 20 17 17 18 17 17 17 17 17 17 17 17 17 17 3 0 0 0 4 17 18 
17 3 0 0 7 12 18 3 0 0 8 11 17 17 17 10 5 0 0 0 133 134 0 0 0 4 17 17 17 17 17 17 10 2 238 2 2 238 2 11 17 21 6 0 0 4 17 17 
17 3 0 0 4 17 10 5 0 0 0 4 17 17 20 3 0 0 0 0 135 136 0 0 0 160 17 17 17 17 17 10 5 0 0 0 0 0 0 4 17 17 3 0 0 4 20 17 
17 33 116 116 34 17 239 0 0 0 0 4 17 17 17 3 0 0 0 0 81 81 7 1 1 12 17 17 17 20 10 5 0 0 0 0 0 0 0 8 11 20 3 0 0 8 11 17 
18 3 0 0 4 17 3 0 0 0 7 12 17 18 17 3 0 0 0 7 233 233 12 18 17 17 17 17 17 10 5 0 0 0 0 0 0 0 0 0 4 17 3 0 0 0 240 17 
10 5 0 0 8 11 3 0 0 0 4 17 17 17 17 3 0 0 0 240 17 17 17 17 17 17 17 10 38 5 0 0 0 0 0 0 0 0 0 0 4 17 239 0 0 0 4 17 
239 0 0 0 0 4 3 0 0 0 8 2 2 11 10 5 0 0 0 4 17 17 17 20 17 10 2 5 131 0 0 0 0 0 0 0 0 0 0 151 40 18 3 0 0 0 4 20 
239 0 0 0 0 4 9 1 23 0 0 0 0 8 5 0 0 0 7 12 17 17 17 17 10 5 0 0 131 0 0 0 0 0 0 0 0 0 0 0 160 17 239 0 0 0 4 17 
9 6 0 7 1 12 17 17 9 1 23 0 0 0 0 0 0 0 4 17 17 17 10 2 5 0 0 0 131 0 0 0 0 0 0 0 0 0 0 151 40 17 9 6 0 0 4 17 
17 3 0 4 17 17 18 17 17 17 21 1 23 0 0 0 0 0 4 17 18 17 3 0 0 0 7 1 37 19 6 0 0 0 0 0 0 0 0 0 4 17 17 3 0 0 4 17 
17 3 0 4 17 17 17 17 17 20 17 17 9 1 6 0 0 0 8 11 17 17 3 0 0 7 12 17 17 18 3 0 0 0 0 0 0 0 0 7 12 17 17 39 77 7 12 18 
17 3 0 4 17 20 17 17 17 17 18 17 17 17 21 6 0 0 0 4 20 17 235 114 115 236 17 17 17 17 9 1 1 1 1 1 1 1 1 12 17 17 10 5 0 4 17 17 
10 5 0 8 11 17 17 17 17 17 17 17 17 17 20 239 0 0 0 8 2 2 5 0 0 4 17 20 20 17 17 17 17 17 17 20 17 17 17 17 18 20 3 0 0 4 18 17 
3 0 0 0 8 2 2 2 2 2 2 11 17 17 17 3 0 0 0 0 0 0 0 0 0 8 238 11 17 17 17 17 17 17 17 17 17 17 17 17 17 17 3 0 0 4 17 17 
3 0 0 0 0 0 7 23 0 0 0 8 11 17 17 9 6 0 0 0 0 0 0 0 0 0 0 8 2 11 17 17 17 17 17 17 17 17 17 17 17 10 5 0 0 4 17 17 
239 0 0 0 0 7 12 3 0 0 0 0 8 11 17 17 9 6 0 0 0 0 0 0 0 0 0 0 0 8 2 11 17 17 17 18 17 17 17 17 10 5 0 0 0 240 17 17 
9 6 0 0 0 4 17 3 0 0 0 0 0 4 17 17 17 239 0 0 0 0 0 0 0 0 0 0 0 0 0 4 20 17 17 17 17 10 2 2 5 0 0 0 0 4 17 18 
17 3 0 0 0 4 20 3 0 0 111 0 0 4 17 18 17 3 0 0 0 0 0 0 0 0 0 0 0 0 0 8 238 2 2 2 2 5 0 0 0 0 0 0 0 4 20 17 
17 3 0 0 0 4 17 3 0 0 81 0 0 4 17 17 17 9 6 0 0 0 0 0 0 0 0 0 0 0 0 0 0 0 0 0 0 0 0 0 0 0 0 0 0 4 17 17 
20 3 0 0 0 4 17 9 6 0 81 0 0 4 20 17 17 17 3 0 0 0 0 0 0 0 0 0 0 0 0 0 0 0 0 0 0 0 0 0 0 0 0 0 0 8 11 17 
17 3 0 0 0 4 17 18 21 6 92 24 27 12 17 17 17 17 3 0 0 0 0 0 0 0 0 0 0 0 0 0 0 0 0 0 0 0 0 0 0 0 0 0 0 0 4 17 
17 9 23 0 24 22 17 17 17 9 233 12 17 17 17 17 17 17 3 0 0 0 0 0 0 0 0 0 0 0 0 7 23 0 0 0 0 0 0 0 0 0 0 0 0 0 240 17 
17 17 21 19 22 17 17 17 17 17 17 17 17 17 17 17 17 17 9 14 0 0 0 0 0 0 0 0 0 0 0 4 9 14 0 0 0 0 0 0 0 0 0 0 0 7 12 17 
17 17 20 17 17 17 17 17 17 17 17 17 17 17 18 17 17 20 17 17 13 1 1 1 1 1 1 1 1 1 1 12 18 17 13 1 1 1 1 1 1 1 1 1 1 12 20 17 
17 17 17 17 17 17 17 17 17 17 17 17 17 17 17 17 17 17 17 17 17 17 18 17 17 17 17 20 17 17 17 17 17 17 17 20 17 17 17 17 17 17 17 18 17 17 17 17 

14 0
0 2
0 0
0 1

3
37 24 1
39 35 1
25 35 1

0
