32 24
148 143 0 0 0 0 0 0 0 144 129 129 101 106 0 0 0 0 0 0 0 0 0 0 0 0 0 0 0 0 0 0 
127 109 143 0 0 0 0 0 107 122 127 127 127 109 101 101 129 143 0 0 0 0 0 0 0 0 0 0 0 0 0 0 
128 127 103 0 0 107 148 101 122 127 127 128 127 127 127 127 127 109 101 101 101 129 106 0 0 0 0 0 0 0 0 0 
127 127 103 0 144 122 127 127 130 127 127 127 127 127 127 127 130 127 127 128 127 127 109 143 0 0 0 0 0 0 0 0 
127 127 103 0 104 127 127 127 127 127 127 127 110 102 178 102 168 121 127 127 127 127 127 141 101 129 101 148 106 0 0 107 
127 110 105 0 104 127 127 127 127 127 127 127 103 0 0 0 131 108 121 127 127 127 127 127 127 127 127 130 195 114 115 196 
127 103 0 0 108 121 127 128 127 127 110 102 105 0 0 0 131 0 108 121 127 127 130 127 127 128 127 127 103 0 0 104 
127 179 0 0 0 104 127 127 127 127 103 0 0 0 0 0 131 0 0 108 121 127 127 127 127 127 127 110 105 0 0 108 
130 103 0 0 0 104 127 127 127 127 103 0 0 0 0 107 167 106 0 0 108 121 127 127 127 127 127 179 0 0 0 0 
127 103 0 0 0 104 127 130 127 127 103 0 0 0 0 104 127 103 0 0 0 108 102 121 127 127 127 179 0 0 0 0 
127 109 106 0 0 108 121 127 127 127 109 106 0 0 107 122 128 103 0 0 0 0 0 104 127 130 127 179 0 0 0 0 
127 127 103 0 0 0 180 127 127 127 127 169 77 0 104 127 127 103 0 0 107 101 101 122 127 127 127 179 0 0 0 0 
127 127 103 0 0 107 122 127 127 127 110 105 0 107 122 127 110 105 0 0 108 121 127 127 128 127 127 109 106 0 0 0 
127 128 103 0 107 122 127 127 127 128 103 0 151 170 127 127 103 0 0 0 0 104 127 127 127 127 127 127 109 106 0 0 
127 127 103 0 104 127 130 127 127 127 103 0 0 108 121 127 109 106 0 0 0 104 127 127 127 127 127 130 127 103 0 0 
127 127 103 0 104 127 127 127 127 127 103 0 0 0 108 121 127 103 0 0 0 104 130 127 127 127 127 127 110 105 0 0 
127 127 103 0 108 102 121 127 127 127 103 0 0 0 0 104 127 103 0 0 0 104 127 127 127 127 127 127 103 0 0 0 
127 127 163 116 116 116 164 127 127 110 105 0 0 0 0 104 127 103 0 0 0 108 121 127 127 128 127 110 105 0 0 0 
127 127 103 0 0 0 104 127 110 105 0 0 0 0 107 122 128 109 106 0 0 0 108 121 127 127 110 105 0 0 0 0 
127 130 109 143 0 0 108 102 105 0 0 0 0 0 104 127 127 127 103 0 0 0 0 108 102 102 105 0 0 0 0 0 
127 127 127 109 124 0 0 0 0 0 0 125 207 208 122 127 127 127 179 0 0 0 0 0 0 0 0 0 0 0 111 0 
127 127 127 127 127 123 101 101 101 147 126 130 227 228 127 127 127 127 109 106 0 0 0 0 0 0 0 0 0 0 81 107 
127 127 128 127 127 127 130 127 127 127 127 127 127 127 127 127 127 127 127 109 101 143 0 0 107 101 143 0 107 101 193 122 
127 127 127 127 127 127 127 127 127 127 127 127 127 128 127 127 127 127 127 130 127 109 147 101 142 127 109 101 142 127 127 127 

0 0

0

1
